00000022000000220000000000
00000022000000220000000000
00110022000000110011001100
00110022000000110011001100
00110000000000110011221100
00110000000011110011221100
00000011000000000022000000
00000011000000000022000000
33000011000022000011331122
33000011000022000011331122
33330000001100002200330000
33330000001100002200330000
00111111333333220000331100
00111111333333220000331100
00000022331100110011001100
00000022331100110011001100
22110022001100110000001100
22110022001100110000001100
00110011001111110011001100
00110011001111110011001100
00110011001111110000000000
00110011000000000000000000
00110000000000000011001100
00110000000111100011001100
00110011000100100011111100
00110011000100100011111100